23
31
11100000000000000000111
11100000000000000000111
11100000000000000000111
11100000000000000000111
11100000000000000000111
11100000000000000000111
11100000000000000000111
11100000000000000000111
11100000000000000000111
11111111110001111111111
11111110000000001111111
11111110000000001111111
11111110000000001111111
11111110000000001111111
11111110000000001111111
11111110000000001111111
11111110000000001111111
11111110000000001111111
11111110000000001111111
11111110000000001111111
11111110000000001111111
11111110000000001111111
11111110000000001111111
11111110000000001111111
11111110000000001111111
11111110000000001111111
11111110000000001111111
11111110000000001111111
11111111111011111111111
11111111111011111111111
11111111111111111111111
