33
23
111111111111111111111111111111111
111111111111111111111111111111111
111111111111111111111111111111111
111111111111111111111111111111111
111001111111111111111111111111111
111001111101000000001111111111111
111001110001111001111110000110111
111000000001111001111000000000111
111000000000000000000000000000111
111000000000000000000000000010111
111000000000000000000000000010111
111000000000000000000000000000111
111100010111111111111110010001111
111111110111111111111110011111111
111111110111111111111110011111111
111111111111111111111111111111111
111111111111111111111111111111111
111111111111111111111111111111111
111111111111111111111111111111111
111111111111111111111111111111111
111111111111111111111111111111111
111111111111111111111111111111111
111111111111111111111111111111111
